...####....
..##...####
.##..###..#
##........#
#......@..#
###.......#
..#..#....#
.##.##.#.##
.#......##.
.#.....##..
.#######...