###########
...........
...........
#.........#
#......@..#
#.........#
#.........#
...........
...........
.#.....##..
.#######...